reference - đề cập
inhabitants - cư dân
wetland - vùng đất ngập nước
appreciate - đánh giá
significance - ý nghĩa
Peatlands - vùng đất than bùn
occur - xảy ra
drained - cạn kiệt
logging - khai thác gỗ
policies - chính sách
intention - chủ đích
Initiatives - sáng kiến
peat - than bùn
gathered - tập hợp
Consequently - do đó
dependent - sự phụ thuộc
livelihoods - sinh kế
mitigating - giảm nhẹ
shade - bóng râm
pulpwood - bột giấy
clearance - giải tỏa
release - giải phóng
catastrophe - thảm hoạ
landmass - đất đai
devastating - tàn phá
seldom - hiếm khi
acknowledges - thừa nhận
sustainability - tính bền vững
fortunes - vận mệnh
deny - từ chối
degradation - suy thoái
ditches - mương
subsidence - sự sụt lún
revenues - doanh thu
fungi - nấm
hurricanes - cơn bão
gathered - tập hợp lại
pace - nhịp độ